5 5
0 0
3 4 4 4 5
6 7 7 7 8
6 7 7 7 8
6 7 7 7 8
9 0 0 0 0