9 9
65 65
211 212 212 212 212 212 212 212 213
221 111 112 112 112 112 112 113 223
221 121 122 122 122 122 122 123 223
221 131 132 132 132 132 132 133 223
024 232 232 232 232 100 232 232 022
221 111 112 112 112 112 112 113 223
221 121 122 122 122 122 122 123 223
221 131 132 132 132 132 132 133 223
231 232 232 232 232 232 232 232 233